################################
#----------------###-----------#
#----------------###-----------#
#------------------------------#
#------------------------------#
#------------------------------#
#-------------####-------------#
#-------------####-------------#
#------------------------------#
#------------------------------#
#------------------------------#
###----------------------------#
###------------#---------------#
###-----------###--------------#
#------------#####-------------#
#-----------#######------------#
#----------#########-----------#
#-----------#######------------#
#------------#####-------------#
#-------------###--------------#
#--------------#---------------#
#--------####------------------#
#------#######-----------------#
#-----#########----------------#
#------######------------------#
#-------####-------------------#
#------------------------------#
#------------------------------#
#------------------------------#
#------------------------------#
#------------------------------#
################################